R 1080 720

SO ./img_manage/textures/texture_files/txt_wall_blue_light.xpm

NO ./img_manage/textures/texture_files/sprite1.xpm

EA ./img_manage/textures/texture_files/txt_wall_blue_dark.xpm

WE ./img_manage/textures/texture_files/txt_floor_blue_1.xpm


1111111111  11111111111
1200000021  10000000001
1000000001  10002020001
1200000001  10000000001
1000000021  10000000001
1200N00001  10001110001111111111
10000000211110001 100000000000011
12000000000000001 1000000000000011
10002200000000001 10000200020000011
11111111111111111 100000020002000011
                  1000000002000200011
                  1000000000020002011
                  10000000000000000001
                  11111111111111111111
