11111111111111111111111111
100000000100000000000000001
100000000100011111111111001
100000000100010000000000001
100000000100010000000000001
100000000100010000000000001
1000110001000100011111111111111111111111111
1000000001000100000000000000000000000000001
1000110001000100000000000000000000000000001
1000000001000100000000000000000000000000001
1000110001000100000000000000000000000000001
1000000000000100000000000011111111111111111
100000000000010000000000001
111111111111111100000000001
000000000000000100000000001
000000000000000100000000001
000000000000000100000000001
000000000000000100000000001
000000000000000100000000001
000000000000000111111111111
