R 1080 720

SO ./img_manage/textures/texture_files/txt_wall_blue_light.xpm

NO ./img_manage/textures/texture_files/txt_wall_blue_dark.xpm

EA ./img_manage/textures/texture_files/txt_wall_blue_light.xpm

WE ./img_manage/textures/texture_files/txt_wall_blue_dark.xpm


111111111111111111111111111
100000000100000000000000001
100000000100011111111111001
100000000000000000000000001
100020000000000000002000001
100000000100010000000000001
1000100001000100011111111111111111111111111
1000000001000100002000000000000000000000001
1000110001000100000000000000000000000000001
1000000001000100000200000000N00000000000021
1000110001000100000000000000000000000000001
1000000000000120000000000011111111111111111
100002000000010000000000001
111111111111111100000000001
               100000000001
               100000000001
               100000000001
               100000000001
               100002000001
               111111111111
