1111111111111111111111
1000000000000000000001
1000000000003004444001
1000000000000004004001
1000000000003004004001
1000222220000004004001
1000200020003004004001
1000220220000004004001
1000000000003000000001
1000000000000000000001
1111111111111111111111