R 1080 720

SO ./img_manage/textures/texture_files/txt_wall_blue_light.xpm

NO ./img_manage/textures/texture_files/txt_wall_blue_dark.xpm

EA ./img_manage/textures/texture_files/txt_wall_blue_light.xpm

WE ./img_manage/textures/texture_files/txt_wall_blue_dark.xpm

111111111111111111111111111
100000000100000000000000001
100000000100011111111111001
1000N0000100010000000000001
100000000100010000000000001
100000000100010000000000001
1000110001000100011111111111111111111111111
1000000001000100000000000000000000000000001
1000110001000100000000000000000020000000001
1000000001000100000002000000000000000000001
1000110001000100000000000000000000000000001
1020000000000100000000000011111111111111111
100000000000010000000000001
111111111111111100000000001
               100000000001
               100000200001
               100000000001
               100000000001
               100000000001
               111111111111
