111111111111111111111111111
100000000000000000000000001
100000000000000000000000001
100000000000000030300000001
100000000000000000000000001
100000000000000030300000001
100000000000000000000000001
100000000000000303000000001
100000000000000000000000001
100000000000000030300000001
100000000000000000000000001
100000000000000030300000001
100000000000000000000000001
111111111111111111111111111