R 1080 720

SO ./img_manage/textures/texture_files/txt_wall_blue_light.xpm

NO ./img_manage/textures/texture_files/sprite1.xpm

EA ./img_manage/textures/texture_files/txt_wall_blue_dark.xpm

WE ./img_manage/textures/texture_files/txt_floor_blue_1.xpm


1111111111
1200000021
1000000001
1200000001
1000000021
1200N00001
1000000021
1200000001
1000220001
1111111111
