00000000000000000000
01111111111111111110
01111111111111111110
01111111112222222220
02222222211111555770
00000000000000000000